.......................
.......................
....o............o.....
....o............o.....
....o...o....o...o.....
........o....o.........
........o....o.........
...........x...........
.......................
...ooo....o...oooo.....
..........o............
....x.....o............
.......................
....oooo.......o.......
....x..........o.......
...............x.......
