....oo.....oo.....oo....
....oo.....oo.....oo....
....xx.....xx.....xx....
....xx.....xx.....xx....
....oo.....oo.....oo....
........................
........................
..oo..ooo..xx..ooo..oo..
..oo..ooo..xx..ooo..oo..
........................
........................
....oo.....oo.....oo....
....xx.....xx.....xx....
....xx.....xx.....xx....
....oo.....oo.....oo....
....oo.....oo.....oo....
