....oo.....oo.....oo....
....oo.....oo.....oo....
....oo............oo....
....oo............oo....
....oo.....oo.....oo....
........................
........................
..oo..ooo......ooo..oo..
..oo..ooo......ooo..oo..
........................
........................
....oo.....oo.....oo....
....oo............oo....
....oo............oo....
....oo.....oo.....oo....
....oo.....oo.....oo....
